0 0 0 0 0 4 0 3 3 4 3 3 3 5 3
0 4 0 4 4 3 0 4 4 4 0 4 0 0 3
0 4 0 0 0 0 3 4 3 4 0 4 0 0 0
0 0 4 0 0 4 0 4 0 4 0 4 4 4 0
6 4 3 3 0 4 0 4 0 4 0 0 0 4 0
4 0 3 4 4 4 4 3 0 0 0 0 4 4 0
4 0 0 0 0 0 3 3 0 0 4 4 4 0 0
0 4 0 0 3 4 4 4 4 0 3 3 4 0 0
3 4 0 0 0 0 0 0 0 0 3 0 4 0 0
3 0 0 0 0 0 0 3 4 4 3 4 4 0 0
0 0 0 3 0 3 3 4 6 0 3 4 3 0 0
0 4 4 3 0 4 0 4 0 0 3 4 3 0 0
0 4 0 4 4 4 4 4 3 3 3 4 0 0 0
3 0 3 0 0 4 0 0 4 4 4 4 3 0 0
4 4 3 3 3 4 0 0 0 0 0 0 0 0 0