4 0 0 5 4 3 4 0 0 0 4 4 0 0 0
4 3 2 0 4 0 4 4 4 0 4 4 4 0 0
4 4 4 0 0 0 4 0 4 0 0 0 4 0 0
0 0 4 4 4 4 4 0 4 4 4 0 4 0 0
0 0 0 0 0 0 0 0 0 0 4 0 4 0 0
0 0 4 4 4 4 4 0 0 0 4 0 4 4 0
0 0 4 0 0 0 4 4 4 0 0 0 0 4 0
0 0 4 4 0 0 0 0 4 4 4 4 4 4 0
0 0 0 4 0 0 0 0 0 0 0 0 0 0 0
0 4 4 4 0 0 0 4 4 4 0 4 4 4 0
0 4 0 0 0 0 0 4 0 4 0 4 4 4 0
0 4 0 0 4 4 4 4 0 4 4 4 0 4 0
0 4 0 4 4 0 0 0 0 0 0 0 4 0 0
0 0 0 0 0 0 0 4 4 4 4 4 4 0 0
4 6 4 0 4 0 0 0 0 0 0 0 0 0 0