1 1 4 4 4 4 4 4 4 0 0 4 4 4 0
0 1 4 4 4 4 0 0 4 0 0 4 3 3 3
0 1 1 1 4 0 0 0 4 0 0 4 0 3 0
3 0 0 1 4 4 4 4 4 0 4 4 3 0 0
3 0 1 1 4 4 3 0 0 0 4 4 4 0 0
0 3 1 4 0 4 1 1 1 0 0 0 4 0 0
1 1 1 4 0 4 1 4 1 4 4 4 4 0 0
1 4 4 4 0 4 1 4 1 4 0 0 0 0 0
1 3 0 0 0 4 1 4 1 4 4 4 4 4 0
1 1 1 1 1 1 1 4 1 1 1 4 4 0 0
3 4 1 4 4 4 4 4 0 0 1 4 4 0 6
0 0 1 0 4 4 0 4 0 0 1 0 0 0 6
0 0 1 4 3 3 0 0 0 0 1 0 0 0 6
5 0 1 4 4 4 4 4 4 0 1 1 1 5 5
6 3 0 3 3 3 0 3 4 0 0 0 0 0 0